Refuse to - отказываться - preposition
Reason for - причина __ - preposition
Follow - следуй, иди за мной - 
puddle - лужа - Place
Compete - соревноваться - youtube
Someone - кто то - 
Because of - из за (твоей собаки) - preposition
Complain - жалуется - Work
it seems to be - это кажется - Phrase
Currency - валюта - 
Property - недвижимость - 
Still - до сих пор - 
Not Definitely - не точно - 
Depends on - зависит от - studies
Spend on - тратить на - preposition
Living - живой - 
Correctly - правильно - 
Enough - хватит - 
Community - общество - 
Sure - конечно - 
Especially - особенно - 
Clean - чистый - 
Disease - болезнь (тяжелая) - youtube
Grateful to for - благодарен __(кому) за - preposition
See you tomorrow - увидимся завтра - Phrase
at the end of the meeting - в конце встречи - Time
Forever - вечно - Time
Sad - грустный - Home
Experience - опыт - youtube
Data - данные - Work
In spite of - несмотря на (с предлогом) - preposition
Age - возраст - 
Get up - вставать - Time
About - (говорить) про - preposition
Frequent - часто происходит - 
Multiply - умножить - Time
Equipment - оборудование - Work
Modern - современный - Place
Translate from into - переводить с на - preposition
Should - следует - 
Important - важный - Work
bruh - братан - Home
Commercial - коммерческий - Work
July - липень - Time
Any longer - не дольше - 
Depend on - зависит от - preposition
Famous - известный - Work
Surprising - удивительно - 
police - полиция - Work
Right - прав - 
Tonight - сегодня вечером - 
Loud - громко - 
Prepare - подготовится - studies
Financial - финансовый - Work
What kind of - какого рода - Phrase
Could - могли (прошедшее) - 
tsunami - цунами - Travel
Forgive - простить - 
app - приложение - 
Bad at - плохо от - preposition
Start - начало (часто) - 
admire - восхищаться - 
Advertising - реклама - Work
Insist on - настаивать на - preposition
Go to bed - ложиться спать - Time
As - в то время когда (я ем _ я гуляю) - 
Hard - усердно - Work
Avenue - проспект - 
daughter - дочка - 
Greatly - очень сильно - 
Century - 100 летие - Time
cat - кот - Home
Razor - бритва - 
Higher - выше - 
run - бежать - 
Bad - плохо - Work
Picture - картина, рисунок - Home
Join - присоединится - 
Ineffective - неэффективно - Work
March - березень - Time
Certainly - конечно - 
Judge - судья - Work
As soon as possible - как можно быстрее - Time
Desk - письменный стол - Work
Approach - подход - 
Close - закрыть - 
Among - серед - preposition
Subject - предмет - 
toothbrush - зубная щётка - Home
Available - доступен - 
Resolve the conflict - решить конфликт - 
Zoo - зоопарк - 
Choice - выбор - 
Before - перед - Time
Guest - гость - Home
Under - под - preposition
ticket - билет - Travel
Pass me - передай мне - 
i mean - я имею в виду - Phrase
Mix up - перемешать - 
keep in touch - оставаться на связи - Phrase
Brave - смелая - 
Take on - одеть (шапку) - clothes
Roof - крыша - 
Together - вместе - Home
taxi - такси - 
Enjoy - наслаждаться(сильно нравиться) - 
Look it up in a dictionary - найти это в словаре - preposition
Capital - столица - Place
Joke - шутка - youtube
Necessary - необходимо - 
Punish - наказывать - 
Dirty - грязный - Home
Chair - стул - Home
Stage - стадия - 
How many - Сколько (друзей) - 
Kind - Добрый - Home
Difficult - тяжелый (уровень) - studies
Authorities - власти - 
Clothes - одежда - Home
Better - лучше - studies
manner - манера - 
Other - других(множина) - 
Thin - тощий - 
Expression - выражение - studies
Square - площадь - 
Warm - тепло - Weather
Valley - долина - 
Memory - память - Work
apartment - квартира - Home
Can - могу - 
Width - ширина - Work
Impress - впечатлять - 
Perfectly realize - прекрасно осознавать - Phrase
Second - секунда - 
Considerably - значительно (С) - 
Powder - порошок - 
Continue - продолжать - 
Wednesday - среда - Time
Birthday - день рождения - Home
Quickly - быстро - Time
Party - вечеринка - 
Take place - проходит (иметь место) - 
Charge - заведует (чем то) - 
Pair - пара - 
From - из (родом из) - preposition
Normal - обычный - 
Dream - мечта - youtube
Own - собственная - Home
Summer - лето - Time
How much - Сколько (денег) - 
First - первое - Time
Marriage - свадьба - Home
Question mark - вопросительный знак - 
Tomorrow - завтра - Time
Share - разделять - 
Good at - хорошо от - preposition
Only once in a year - только раз в год? - Phrase
Mention - упоминать - 
I busy next week - я занят на следующей неделе - Time
Border - граница - 
Assistant - ассистент - 
Simplicity - простота - studies
The Costs - издержки, расходы - 
Rest - отдыхать - 
Simple - простой - studies
Bathroom - ванная - Place
waterfall - водопад - Place
Religious - верующая - 
For years - годами - Time
Friendly - дружелюбный - duolingo
Adapt to - адаптироваться к - preposition
Cheap - дешевый - Home
Against - против - Work
Fluently - свободно - studies
Area - область, район - Place
Edge of - край _ - preposition
Advanced - продвинутый - studies
The day after tomorrow - послезавтра - Time
Unknown - неизвестно - Work
Miss - соскучиться (за кем - Home
Morning - утро - Time
For - в течении времени - preposition
calm down - успокоиться - Phrase
He is away - он отсутствует (уехал далеко) - Phrase
Responsible - ответственный - 
Begin - начало (формально) - 
Append - добавить - Work
Exercise - заниматься спортом - 
Cheaply - дешево - 
Often - часто - 
Keen on - увлекатся - preposition
Expensive - дорогой - Home
Angry - злой - Work
go - идти - 
Department - отдел - 
Real - настоящая - 
Issue - проблема - 
Absence - отсутствие - 
nasty weather - неприятная погода - Phrase
Point of view - точка зрения - Phrase
Proud of - гордится за - preposition
Just in case - на всякий случай - Phrase
Recent - свежая - 
Behind - позади - preposition
Careful - осторожно - 
Educated - образованный - studies
Towards - (бегут) в направлении (нас) - 
Zip it - закрой рот - Phrase
Go Shopping - ходить за покупками - Phrase
Lend - давать в долг - Work
pass - сдать (тест) - studies
Attitude to - отношение к - preposition
Letter - письмо - 
Participate - принимать участие - 
Absent - отсутствует - 
Will be able - смогу (будущее) - 
bloody - кровавый - 
Point at - указать на - preposition
Get dark - темнеет - Weather
Private - приватно - 
Trousers - брюки - clothes
Everywhere - везде - 
Start doing - начать делать - 
Monday - понедельник - Time
October - жовтень - Time
Opposite - противоположные - 
Prefers - предпочитает - 
Afternoon - днем - 
Yard - улица, двор - 
Fruit - фрукты - 
Rude - грубый - 
Cost - стоить (глагол) - 
April - квітень - Time
Independent of - независимая от, самостоятельный - preposition
Purpose - цель - 
Regions - район - 
Range - диапазон - Work
Rightly - правильно (r) - studies
Inspired - вдохновлять - 
Winter - Зима - Time
In August - в августе - preposition
Despite - не смотря на (одно слово) - 
Event - событие - Work
Mad - сумасшедший - 
Sing - співаю - 
Table - стол - youtube
Guard - охранник - Work
Sell - продавать - Work
Siblings - братья и сёстры - 
Stupid - глупый - Work
Carefully - осторожнее - 
Devote to - уделять (время) для - preposition
Improve - улучшить - studies
Pleasure - удовольствие - Home
Invent - изобретать - 
Foreign - иностранный - studies
Fresh - свежий - 
give - давать - 
Elementary - элементарный - studies
Each other - друг друга - Phrase
The most interesting - самый интересный - Phrase
Exactly - точно! , конкретнее - 
Family - семья - Home
Smile at - улыбается над - preposition
Become - стать кем то - 
Opinion - мнение - Work
Disagree - не соглашаться - Work
Clever - умный - Work
What - что - 
Confuse - перепутать - 
Usually - обычно - Time
Dark - темно - Weather
Local - местный - Place
jug - кувшин - Home
North - север - 
I'll - болен - Home
Only - только (он) - 
Delicious - очень вкусно - youtube
Separately - раздельно - youtube
But - но - 
Trust - доверяю - Work
Too - тоже (3 буквы) - 
Wait - жди - Time
Spring - весна - Time
Free - (быть) свободным - 
Not necessarily - не обязательно - Phrase
Tired of - устал от - preposition
Tower - башня - 
Serious - серьезный - 
How often - как часто - Time
Until - (с начала) до (конца) - 
Competition - соревнование - studies
Main - главный - Work
Wish - желаю - 
Everyone - все(he, she) - 
Easy - легко - 
Sunday - воскресенье - Time
Month - месяц - Time
After - после - preposition
Threat - угроза - 
Meat - мясо - Home
Wrong - не прав - Work
Garden - сад - Place
Bring - приносить - 
Influence - влиять на - preposition
Adult - взрослый - Home
Church - церковь - Place
Who - кто - 
Tall - высокий - 
ocean - океан - Place
The only right - единственно верное - 
Even - даже (навіть) - 
Early - рано - Time
City - город - Place
Beer - пиво - 
Another - другой, другая - 
Third - третье - Time
Useless - бесполезный - Work
train - тренировка - Home
A lot - много - 
Keep - сохранить - 
Impolite - невежливый - 
Attack - атаковать - 
Wise - мудрый - studies
Raise - растить - 
Worry - беспокоить - Home
In The end - в конце - studies
Look at - посмотри на (него) - preposition
Equal - одинаковые - Work
Play - играть - Home
Take part - принимать участие - 
Busy - занят - Work
Huge - огромный - 
Decade - 10 летие - Time
Glad - рада (видеть) - 
Nobody - ніхто - 
Anywhere - в любом месте - 
Elder - старше - youtube
Really - конечно - 
No Biggie - не страшно - Phrase
Solution to - решение __ - preposition
Swim - плавать - youtube
Potential - потенциальный - Work
Calculate - рассчитать - 
Phrase - фраза - youtube
Lazy - ленивые - Home
constant - постоянный - 
Present day - сегодня - Time
Walk - гулять - 
Advertisement - рекламное объявление - youtube
Sooner or later - рано или поздно - Phrase
Flat - квартира - Home
Piss me off - вывести из себя - Phrase
In the beginning - в начале - preposition
Uncle - дядя - 
Light - светло, свет - 
Double - удвоить - 
When - когда - 
Evening - вечер - Time
Answer - ответить на - 
Health - здоровье - Home
Run away - убегай - 
Illness - болезнь (простуда) - youtube
Laugh at - смеяться над - preposition
Forget - забывать - studies
Convenient - подходящий - 
The same - тоже самое (два слова) - 
An Important - не важный - Work
Special - особенный - 
On a regular basis - на регулярной основе (регулярно) - preposition
Watch your mouth - следи за словами - 
Pass by - проходят мимо - 
Check - проверить - 
Prison - тюрьма - 
Suit - подходит - 
Marry - жениться на - preposition
Entry - вход - 
Buy - покупать - Work
Reinvent - переизбирать - 
Short - короткий - 
Fast - быстро - 
That - (i known) что - 
August - серпень - Time
Sentence - речення - studies
Dry - сушить - Home
Don't freak out - не паникуй - Phrase
Pronunciation - произношение - 
Will finish doing - закончит делать - 
The worst - самый худший - 
Low - низкий - 
Divorced - разведен - Home
always the same - всегда одно и тоже - Phrase
Useful - полезный - Work
So what - ну и что? - 
Deny - отрицать - 
water - вода - Place
At least - принаймні, хотя бы - 
Feeling - чувство - Home
Birth - рождение - Home
Objective - цель (O) - 
Do The Shopping - делать покупки - Home
Talk - разговаривать - 
Stay - остаться - 
Tell - сказать (ей) - 
Will Get tired - скоро устанешь - 
Continue doing - продолжить делать - 
Crazy - сумасшедший - 
It's just a mouse - это просто мышь - preposition
Great - огромное (удовольствие) - 
Fair - ярмарок - Place
Cry - плакать, слёзы - Home
Today - сегодня - Time
Explanation - объяснения - 
Present - присутствует - 
I feel sorry for the boy - мне жаль этого парня - 
False - не правда - Work
Take - брать, принять - 
Farm - ферма - Place
Report - отчёт - 
On time - вовремя - Phrase
Activity - деятельность - 
Lucky - везучий - 
Will Continue doing - продолжить делать - 
Slowly - медленно - Time
On Wednesdays - по средам - preposition
More than enough - больше чем достаточно - 
West Coast - западный берег - 
Already - уже - preposition
Holy crap - чёрт возьми - Phrase
Heavy - тяжелый (груз) - 
November - листопад - Time
Travel - путешествовать - youtube
Single - один - Home
Pay for - платить за - preposition
Current - текущий (курс) - 
Worker - рабочий - 
Aunt - тетка - 
Waiter - официант - 
Possible - возможно - 
Alone - (живёт) сама - youtube
owe them - Должен им - 
Salary - зарплата - 
To be - быть - 
Evidence - доказательство - 
Nowadays - настоящее время - Time
Take off - снять (одежду) - clothes
Legal - законный - Work
Husband - муж - Home
Certain - уверен - 
Native speaker - носитель языка - studies
Poor - бедный - Home
Come back - вернуться (два слова) - 
Satisfied with - удовлетворён с - preposition
Comfortable - удобное - youtube
Obviously - очевидно - studies
Thursday - четверг - 
Think it over - обдумать это - 
Notice - заметят - 
Must - должен - 
Shirt - рубашка - 
Wheel - колесо - 
Career - карьера - Work
Amazing - восхитительно - 
Belong to - принадлежать - preposition
Intermediate - средний - studies
Any more - некогда больше - 
Listen to - слышать кого - то
Powerful - мощный - 
Produce - производить - 
Unusual - необычно - 
river - река - Place
React to - реагировать на - preposition
By profession - по профессии - 
Easily - спокойно - 
visa - виза - 
However - зато, про те - preposition
Furniture - мебель - youtube
Promise - обещать - Home
Walk by - идти мимо - 
Wife - жена - Home
Speak - говорить - 
Impossible - невозможно - 
Whole night - вся ночь - 
Measure - меры - 
On a business trip - в командировке - Work
Younger - младший (брат) - youtube
Return - вернуться (одно слово) - 
Walk into - зайти внутрь - 
Receive - получать - 
During - на протяжении (моего сна) - 
Tremendous - огромный - 
Town - город, квартал - 
Dictionary - словарь - studies
Color - цвет - duolingo
Adjective - прилагательное - 
think - думать - 
Have - иметь - 
Definitely - точно - 
Prepare for - подготовиться к - preposition
ok - окей - 
Thing - вещь - Home
Go out - идти на выход, выходить - 
Green - зелёный - 
Compare - сравнить - Work
Grown Up - взрослый - Home
Dangerous - опасно - Work
abroad - за границу - Travel
without - без - preposition
tent - палатка - Place
car - машина - 
Artist - художник - 
Bowl - миска - 
The staff - сотрудники - 
Have read - прочитать - 
High - высокий - 
small - маленький - 
Success - успех - Work
map - карта - Place
Road - дорога - 
Inside - изнутри, внутри - preposition
Sign - подписать - Work
Match more - намного больше - Phrase
Completely - полностью (согласен) - 
Earn - заработать - Work
Perform - исполнять (выступать) - 
Sales - продажи - 
Manage - уметь (управлять) - 
ship - корабль - Place
Late - опаздывающий - 
Meaning - значение - studies
Everybody - все body - 
Control - контролирую - 
Article - статья - Work
May - травень - Time
January - січень - Time
Order - приказывать - Work
As always - как всегда, як завжди - 
Corner - перекресток - Place
Full of - полон чего - 
Reply - ответ (редко) - youtube
Wonderful - Замечательный, чудесный - Home
Castle - замок - Place
explain - объясни - 
One more time - еще раз - Phrase
February - лютий - Time
What time - в какое время - Time
Married - женат - Home
Right now - прямо сейчас - Time
Bird - птица - Home
be able - смогу (будущее) - youtube
Finish it - закончить это - 
Near - близко - 
Library - библиотека - studies
Week - неделя - Time
Criminal - преступник - 
Tuesday - вторник - Time
Funny - забавно - Home
Passion - страсть - 
Autumn - Осень - Time
sea - море - Place
Front - перед (домом) - 
Little - мало - 
The end - конец - 
Bed Sheet - простынь - 
Will it last for - это будет длиться ...? - preposition
Egg - яйцо - Home
Much - много - Home
Saturday - суббота - Time
Nowhere - нигде - 
Inconvenient - неудобно (время) - youtube
Achieve this aim - достигнуть этой цели - 
Remember - помнить - studies
Different - другой, разные - 
Afraid of - испуган от - preposition
Fat - толстый - youtube
Disappointed - расстроенные - 
Lawyer - юрист - Work
Catch - поймать - 
Yesterday - вчера - Time
flee - спасаться бегством - Phrase
Except for - кроме __(огурцов) - preposition
Apologize - извиняться - 
Interested in - заинтересован в - preposition
Just in time - как раз вовремя - Phrase
Decision - решение - Work
Coast - стоить (глагол) - youtube
gloomy - пасмурный - Weather
Young - молодой - 
again - Снова - 
Friday - пятница - Time
at first - сначала - Time
In a year - (выучить) за год - Time
Might - возможно (modal) - 
Behave - ведёт себя - 
Worse - хуже - 
Mean - означает (глагол) - studies
Fourth - четвёртое - Time
Get - добираться - Home
September - вересень - Time
Whose - чей, чья - 
June - червень - Time
Behaviour - поведение - youtube
Truth - правда - Work
Bear - медведь - 
Vegetables - овощи - 
a Bit - немного - Phrase
Waiter - официант - 
Interrupt - перебивать - 
multiplication - умножение - studies
Attractive - привлекательный - 
Express - выразят, выскажут - 
Other side - другая сторона - Phrase
Thoroughly - тщательно - 
Guess - отгадать - 
Significantly - значительно (S) - 
Also - тоже (4 буквы, одно слово) - 
Far - Далеко - 
Send - отправить - 
There - там - 
generation - поколение - Time
Long - длинный - 
Include - включает (еда) - 
Windy - ветреный - Weather
lake - озеро - Place
Condition - условия - studies
Kitchen - кухня - 
Some - некоторый - 
Get a job - получить работу - Work
Polite - вежливый - 
Borrow - брать в долг - 
Bilingual - двуязычный (знает два языка) - 
bus - автобус - Place
Criticize - критикует - youtube
On Holiday - отпуск - Work
Will Start doing - начнёт делать - 
Regret - сожалеть - 
Inform - информировать - 
Market - рынок - Place
Division - ділення - Time
Armchair - кресло - Work
Go on - продолжать 2 слова - 
Voice - голос - 
Frighten - пугает - youtube
Tasty - вкусно - youtube
Neither me nor yours - не моя и не твоя - Phrase
Cook - готовить еду - Home
Familiar - знакомо - 
Route - маршрут - 
communicate - общаться - 
Ground - земля - Place
Slim - стройный - 
heart - сердце - Home
December - грудень - Time
Fond of - обожаю - preposition
Only once - только раз - Phrase
Rains - дощ - Weather
He is out - его нет дома (но он рядом) - Phrase
In general - в основном - preposition
Achievement - достижение - 
Then - тогда (почему) - 
Eyes - глаза - Home
Final - финальное - 
Here - здесь - 
Excellent - отлично - 
Earlier - ранее - Time
You don't say - не может быть - Phrase
Waste of time - потеря времени - Phrase
Land - дать в долг - 
Brilliant - блестящий - studies
How - как - 
Celebrate - праздновать - youtube
beach - пляж - Place
Somebody - кто нибудь body - 
Where - где - 
Trip - поездка - Work
Employee - работник - Work
Why - почему - 
Pocket - карман - clothes
Somehow - как то - 
Island - остров - Place
Hurry up - торопиться - Phrase
Floor - пол - Home
Rich - богатый - Work
Bag - сумка - 
Leave - покидать - 
On top - сверху - Phrase
Between - между - preposition
Clear - ясно понятно - 
Correct - правильный - 
chief - начальник - Work
In front - перед (собакой) - preposition
Sleep on it - обдумать еще раз - Phrase
at the beginning of the year - в начале этого года - Time
Hour - час - Time
Low blow - удар ниже пояса - Phrase
Beginner - новичок - studies
Go away - уйди - 
last for about - (это будет) длится около - 
Write it down - записывать что то - Phrase
On Tuesday - во вторник - preposition
Year - год - Time
Cold - холодно - Weather
Length - длина - Work
quantity - количество - Work
Lead to - приводит к - preposition
Hard working - трудолюбивый - Work
Son - сын - 
Hot - жарко - Weather
Skirt - юбка - 
Repair - исправить - 
catch up - догонять(два слова) - Phrase
