nature - природа - nature
flower - цветок - nature
water - вода - nature
air - воздух - nature
life - жизнь - nature
death - смерть - nature
land - земля - nature
star - звезда - nature
grass - трава - nature
tree - дерево - nature
gold - золото - nature
silver - серебро - nature
sound - звук - nature
fire - огонь - nature
sky - небо - nature
ground - земля - nature
sun - солнце - nature
rain - дождь - nature
moon - луна - nature
stone - камень - nature
wind - ветер - nature
smoke - дым, курить - nature
river - река - nature
sea - море - nature
lake - озеро - nature
ocean - океан - nature
beach - пляж - nature
forest - лес - nature
ice - лёд - nature
color - цвет - nature
weather - погода - nature
snow - снег - nature
animal - животное - nature
bird - птица - nature
egg - яйцо - nature
dog - собака - nature
cat - кошка - nature
bear - медведь - nature
wolf - волк - nature
fish - рыба - nature
dolphin - дельфин - nature
camel - верблюд - nature
horse - лошадь - nature
chicken - курица, цыплёнок - nature
eagle - орёл - nature
cow - корова - nature
duck - утка - nature
goose - гусь - nature
mouse - мышь - nature
pig - свинья - nature
rat - крыса - nature
bull - бык - nature
lion - лев - nature
bee - пчела - nature
spider - паук - nature
elephant - слон - nature
monkey - обезьяна - nature
tiger - тигр - nature
fox - лиса - nature
shit - дерьмо - nature
people - люди - nature
man - человек, мужик - nature
woman - женщина - nature
child - ребёнок - nature
person - человек - nature
family - семья - nature
mother - мать - nature
father - отец - nature
parent - родитель - nature
girl - девочка - nature
boy - мальчик - nature
enemy - враг - nature
friend - друг - nature
wife - жена - nature
dad - папа - nature
mom - мама - nature
son - сын - nature
baby - (babe) крошка - nature
brother - брат - nature
sister - сестра - nature
daughter - дочь - nature
husband - муж - nature
teacher - учитель - nature
soldier - солдат - nature
engineer - инженер - nature
policeman - полицейский - nature
guy - парень, чувак - nature
girlfriend - девушка (его) - nature
boyfriend - парень (её) - nature
sir - сэр - nature
body - тело - body
finger - палец - body
hand - рука - body
head - голова - body
wing - крыло - body
face - лицо - body
brain - мозг - body
eye - глаз - body
nose - нос - body
ear - ухо - body
mouth - рот - body
foot - нога - body
heart - сердце - body
soul - душа - body
mind - разум - body
voice - голос - body
hair - волосы - body
blood - кровь - body
time - время - time
year - год - time
hour - час - time
week - неделя - time
month - месяц - time
day - день - time
evening - вечер - time
night - ночь - time
morning - утро - time
January - январь - time
February - февраль - time
March - март - time
April - апрель - time
June - июнь - time
July - июль - time
August - август - time
September - сентябрь - time
October - октябрь - time
November - ноябрь - time
December - декабрь - time
Monday - понедельник - time
Tuesday - вторник - time
Wednesday - среда - time
Thursday - четверг - time
Friday - пятница - time
Saturday - суббота - time
Sunday - воскресенье - time
spring - весна - time
summer - лето - time
autumn - осень - time
winter - зима - time
thing - вещь - noun
ring - кольцо - noun
toy - игрушка - noun
book - книга - noun
textbook - учебник - noun
notebook - тетрадь - noun
page - страница - noun
tale - сказка - noun
button - кнопка - noun
door - дверь - noun
car - автомобиль - noun
ship - корабль - noun
bus - автобус - noun
bike - мотоцикл - noun
pen - ручка - noun
pencil - карандаш - noun
mirror - зеркало - noun
news - новости - noun
map - карта - noun
bed - кровать - noun
picture - картинка - noun
table - стол - noun
wall - стена - noun
window - окно - noun
box - коробка - noun
present - подарок - noun
ball - мяч - noun
screen - экран - noun
net - сеть - noun
knife - нож - noun
spoon - ложка - noun
fork - вилка - noun
cup - чашка - noun
plate - тарелка - noun
clock - часы - noun
coin - монета - noun
device - прибор - noun
food - еда - food
breakfast - завтрак - food
lunch - обед - food
dinner - ужин - food
supper - поздний ужин - food
bottle - бутылка - food
milk - молоко - food
meat - мясо - food
sugar - сахар - food
cake - пироженое - food
cheese - сыр - food
fruit - фрукт - food
bread - хлеб - food
tea - чай - food
soup - суп - food
pasta - макароны - food
beer - пиво - food
apple - яблоко - food
lemon - лимон - food
cherry - вишня - food
juice - сок - food
world - мир - noun
country - страна - noun
kingdom - королевство - noun
capital - столица - noun
city - город - noun
place - место - noun
school - школа - noun
lesson - урок - noun
hospital - больница - noun
job - работа - noun
market - рынок - noun
street - улица - noun
road - дорога - noun
town - город - noun
shop - магазин - noun
money - деньги - noun
price - цена - noun
home - дом - noun
house - дом - noun
castle - замок - noun
room - комната - noun
kitchen - кухня - noun
bedroom - спальня - noun
toilet - туалет - noun
bathroom - ванная - noun
word - слово - noun
letter - буква - noun
message - сообщение - noun
speech - речь - noun
song - песня - noun
name - имя, назвать - noun
nickname - прозвище - noun
question - вопрос - noun
fun - веселье - noun
truth - правда - noun
joke - шутка - noun
language - язык - noun
game - игра - noun
party - вечеринка - noun
king - король - noun
queen - королева - noun
god - бог - noun
devil - дьявол - noun
art - искусство - noun
hell - ад - noun
paradise - рай - noun
way - путь - noun
force - сила - noun
power - сила - noun
top - верх - noun
size - размер - noun
half - половина - noun
speed - скорость - noun
luck - удача - noun
trouble - проблема - noun
fortune - удача, случай - noun
danger - опасность - noun
war - война - noun
victory - победа - noun
peace - мир - noun
holiday - праздник - noun
web - сеть, паутина - noun
mail - почта - noun
do - делать - verb
have - иметь - verb
go - идти - verb
get - получать - verb
know - знать - verb
make - делать - verb
can - может - verb
could - мог - verb
must - должен - verb
think - думать - verb
like - любить - verb
see - видеть - verb
take - брать - verb
come - приходить - verb
work - работать - verb
use - использовать - verb
look - смотреть - verb
want - хотеть - verb
hope - надеяться - verb
find - находить - verb
give - давать - verb
tell - говорить - verb
call - звать - verb
need - нуждаться - verb
may - мочь - verb
wash - мыть - verb
feel - чувствовать - verb
play - играть - verb
try - пробовать - verb
live - жить - verb
show - показывать - verb
ask - спрашивать - verb
help - помогать - verb
talk - разговаривать - verb
move - двигаться - verb
begin - начинать - verb
become - становиться - verb
build - строить - verb
start - начинать - verb
change - изменять - verb
let - позволять - verb
run - бежать - verb
write - писать - verb
keep - держать - verb
hold - держать - verb
repeat - повторять - verb
put - класть - verb
end - заканчивать - verb
study - учиться - verb
hear - слышать - verb
teach - учить - verb
open - открывать - verb
add - добавлять - verb
love - любить - verb
believe - верить - verb
read - читать - verb
mean - значить - verb
pay - платить - verb
stand - стоять - verb
understand - понимать - verb
learn - учиться - verb
sit - сидеть - verb
win - побеждать - verb
break - ломать - verb
lose - проигрывать - verb
watch - смотреть - verb
speak - говорить - verb
stop - останавливать - verb
walk - идти пешком - verb
cut - резать - verb
wait - ждать - verb
kill - убивать - verb
buy - покупать - verb
remember - помнить - verb
die - умирать - verb
answer - отвечать - verb
fight - драться - verb
pull - тянуть - verb
paint - рисовать - verb
eat - есть - verb
listen - слушать - verb
smile - улыбаться - verb
save - спасать - verb
choose - выбирать - verb
sleep - спать - verb
travel - путешествовать - verb
fill - наполнять - verb
push - толкать - verb
fall - падать - verb
fly - летать - verb
hunt - охотиться - verb
finish - заканчивать - verb
delete - удалять - verb
sing - петь - verb
cook - готовить - verb
dream - мечтать - verb
dance - танцевать - verb
sell - продавать - verb
drink - пить - verb
respect - уважать - verb
enjoy - наслаждаться - verb
forget - забывать - verb
wish - желать - verb
cry - плакать - verb
mix - смешивать - verb
print - печатать - verb
jump - прыгать - verb
hate - ненавидеть - verb
kiss - целовать - verb
excuse - извинять - verb
translate - переводить - verb
swim - плавать - verb
relax - расслабляться - verb
fuck - трахать - verb
more - более - adjective
most - наиболее - adjective
less - менее - adjective
least - наименее - adjective
left - левый - adjective
new - новый - adjective
good - хороший - adjective
better - лучший - adjective
bad - плохой - adjective
worse - хуже - adjective
the - worst самый худший - adjective
last - последний - adjective
own - собственный - adjective
usual - обычный - adjective
long - длинный - adjective
high - высокий - adjective
little - маленький - adjective
great - великий - adjective
real - реальный - adjective
old - старый - adjective
big - большой - adjective
same - тот же - adjective
next - следующий - adjective
large - обширный - adjective
kind - добрый - adjective
small - маленький - adjective
young - молодой - adjective
beautiful - красивый - adjective
cheap - дешёвый - adjective
light - лёгкий - adjective
dark - тёмный - adjective
true - верный, правильный - adjective
hard - тяжёлый, жёсткий - adjective
soft - мягкий - adjective
close - близкий - adjective
far - далёкий - adjective
final - последний - adjective
low - низкий - adjective
easy - лёгкий - adjective
difficult - трудный - adjective
strong - сильный - adjective
quick - быстрый - adjective
short - короткий - adjective
slow - медленный - adjective
dear - дорогой, уважаемый - adjective
glad - радостный - adjective
happy - счастливый - adjective
drunk - пьяный - adjective
sad - грустный - adjective
dead - мёртвый - adjective
ready - готовый - adjective
fake - поддельный - adjective
social - общественный - adjective
random - случайный - adjective
fast - быстрый - adjective
main - главный - adjective
hot - горячий - adjective
cold - холодный - adjective
warm - тёплый - adjective
full - полный - adjective
heavy - тяжёлый - adjective
black - чёрный - adjective
white - белый - adjective
red - красный - adjective
green - зелёный - adjective
blue - синий - adjective
yellow - жёлтый - adjective
gray/grey - серый - adjective
pink - розовый - adjective
orange - оранжевый - adjective
clean - чистый - adjective
dirty - грязный - adjective
nice - приятный - adjective
modern - современный - adjective
right - правильный - adjective
wrong - неправильный - adjective
fresh - свежий - adjective
strange - странный - adjective
crazy - безумный - adjective
mad - безумный - adjective
wild - дикий - adjective
cool - классный - adjective
sweet - сладкий - adjective
number - число - число
zero - 0 - число
one - 1 - число
two - 2 - число
three - 3 - число
four - 4 - число
five - 5 - число
six - 6 - число
seven - 7 - число
eight - 8 - число
nine - 9 - число
ten - 10 - число
eleven - 11 - число
twelve - 12 - число
thirteen - 13 - число
fourteen - 14 - число
fifteen - 15 - число
sixteen - 16 - число
seventeen - 17 - число
eighteen - 18 - число
nineteen - 19 - число
twenty - 20 - число
hundred - 100 - число
thousand - 1000 - число
first - первый - число
second - второй - число
third - третий - число
just - просто - adverb
now - сейчас - adverb
then - тогда - adverb
back - назад - adverb
forward - вперёд - adverb
well - хорошо - adverb
only - только - adverb
also - также - adverb
even - даже - adverb
very - очень - adverb
down - вниз - adverb
still - всё ещё - adverb
never - никогда - adverb
again - снова - adverb
today - сегодня - adverb
tonight - сегодня - adverb
tomorrow - завтра - adverb
yesterday - вчера - adverb
always - всегда - adverb
enough - достаточно - adverb
often - часто - adverb
together - вместе - adverb
already - уже - adverb
maybe - может быть - adverb
soon - скоро - adverb
forever - навсегда - adverb
all - все - pronoun
any - любой - pronoun
anybody - любой - pronoun
anyone - любой - pronoun
anything - что угодно - pronoun
each - каждый - pronoun
every - каждый - pronoun
everybody - каждый (человек) - pronoun
everything - всё - pronoun
he - он - pronoun
here - здесь - pronoun
it - это - pronoun
itself - сам - pronoun
oneself - себя - pronoun
nobody - никто - pronoun
nothing - ничто - pronoun
she - она - pronoun
some - некоторое количество - pronoun
somebody - кто нибудь - pronoun
someone - кто нибудь - pronoun
something - что нибудь - pronoun
sometimes иногда - pronoun - 
such такой - pronoun - 
there там - pronoun - 
they они - pronoun - 
this - этот - pronoun
that - тот - pronoun
these - эти - pronoun
those - те - pronoun
we - мы - pronoun
you - ты - pronoun
how - как - pronoun
when - когда - pronoun
where - где - pronoun
what - что - pronoun
who - кто - pronoun
why - почему - pronoun
which - который - pronoun
other - другой - pronoun
another - любой другой - pronoun
many - много - pronoun
much - много - pronoun
few - мало - pronoun
away - прочь - pronoun
along - вдоль - pronoun
behind - за - pronoun
else - ещё - pronoun
upon - на - pronoun
about - о - pronoun
above - над - pronoun
after - за - pronoun
among - среди - pronoun
around - вокруг - pronoun
at - у, на - pronoun
before - до - pronoun
between - между - pronoun
through - через - pronoun
by - через - preposition
for - для - preposition
from - из - preposition
in - в - preposition
into - в - preposition
near - около - preposition
under - под - preposition
with - с - preposition
without - без - preposition
and - и - preposition
because - потому что - preposition
against - против - preposition
but - но - preposition
if - если - preposition
not - не - preposition
or - или - preposition
so - так - preposition
than - чем - preposition
too - слишком - preposition
while - пока - preposition
until - до тех пор - preposition
of - из - preposition
off - из, вне - preposition
on - на - preposition
over - над - preposition
to - в, к - preposition
please - пожалуйста - preposition
sorry - мне жаль - preposition
hello - привет - preposition
bye - пока - preposition
hi - привет - preposition
goodbye - до свидания - preposition
yes/yeah - да - preposition
no - нет - preposition
