Currently                 - В настоящее время, теперь
least                     - наименее, как минимум
to                        - в, к
still                     - всё ещё, ещё, до сих пор
ball                      - мяч
excuse                    - извинять
into                      - в
begin                     - начинать
Potential                 - потенциальный
fake                      - поддельный
Attractive                - привлекательный
notify                    - уведомить, поставить в известность
Notification              - уведомление
work properly             - работать правильно
ridge                     - хребет
Lay laid laid             - ставить
Woke up                   - проснуться
Specious                  - просторная
Notificat                 - уведомлять
Hurt hurt hurt            - задеть, слегка повредить
It stopped working properly - это сломалось
Sing sang sung            - петь
Forget forgot forgot      - забывать
Hit hit hit               - ударить
Pie                       - пирог
Hide hid hidden           - прятать
Ride rode ridden          - водить, ехать
Feed fed fed              - кормить
Swim swam swum            - плавать
Pond                      - пруд
Lend lent lent            - одолжить (кому то)
Blow blew blown           - дуть
Injury                    - сильно задеть
Dream dreamt dreamt       - мечтать
Steal stole stolen        - украсть
Jewelry                   - украшения
Wake woke woken           - просыпаться
Dig dug dug               - рыть
Hole                      - яма
Forgive forgave forgiven  - прощать
Hold held held            - держать в руках
Break down                - сломаться
Catch caught caught       - ловить
Draw drew drawn           - рисовать
Masterpiece               - шедевр
Courageously              - отважно
Deal dealt dealt          - иметь дело
Customer                  - покупатель
Throw threw thrown        - бросать
Wear wore worn            - носить (одежду)
Fashionable               - модная
Teach taught taught       - преподавать
Lie lay lain              - лежать
Lie lied lied             - Врать (не путать с лежать)
Fly flew flown            - летать
Instead of                - вместо (него)
Half an hour              - полчаса
remove                    - удалять
