Hang hung hung - вешать
Bite bit bitten - кусать
Hide hid hidden - прятать
Allow allowed allowed - разрешить (A)
Buy bought bought - покупать
bring brought brought - принести
Catch caught caught - ловить
Swim swam swum - плавать
Lie lay lain - лежать
Lay laid laid - ложить
Steal stole stolen - украсть
Light lit lit - зажечь
Lack - нехватка, недостаток
Shape - форма (состояние)
Doubt - сомнение
Consequence - последствие
Fault - вина
kebab - case
Learn something new - узнать что
Raise - растить
Passion - страсть
Sure - конечно
Exactly - точно! , конкретнее
Careful - осторожно
Objective - цель (O)
Huge - огромный
How much - Сколько (денег)
Have read - прочитать
The worst - самый худший
Serious - серьезный
Calculate - рассчитать
Degree - научная степень
Sofa - диван
Root - корень
Cabinet - шкаф
Hotel - отель
String - нитка, шнурок
West - запад
Rent - арендовать
Boat - лодка
Pan - сковорода
Pool - бассейн
Soap - мыло
Sponge - губка
Chain - цепь
Novel - роман
Almost - майже, почти
Colorful - блестящий
Born - рожденный
Go anywhere you want to - иди куда угодно
Scissors - ножницы
Flight - полет, рейс
Guide - гид
Won - выиграл
The machine - машина
Lost - потеряла
Brown - коричневый
The window - окно
Basket - корзина
Individual - личность
Unusual - необычно
Felt - упал
Grade - класс
Ands - заканчивается
Whenever - когда угодно
Edge of the building - край здания
Approximately - приблизительно
Pretty tired - достаточно уставший
Perfectly - полностью
Bicycle - велосипед
Any more - некогда больше
Run away - убегай
Comb - гребешок
The couple - эти женатики (пара)
Both sides - обе стороны
bloody - кровавый
Mention - упоминать
Waiter - официант
Spoke - говорил (прошлое)
The way - путь
Option - вариант
Really - Действительно
Follow - следуй (иди за мной)
Stage - стадия
Pass me - передай мне
Everyone - все(he, she)
Regret - сожалеть
Award - награда
Apologize - извиняться
Will Get tired - скоро устанешь
Not Definitely - не точно
More than enough - больше чем достаточно
Achievement - достижение
Familiar - знакомо
Artist - художник
Express - выразят, выскажут
Reinvent - переизбирать
Victim - жертва
Motorcycle - мотоцикл
Bell - звон, колокол
Airplane - самолет
Departure - отъезд
Village - село
Lady - пані
Suitcase - чемодан
Vehicle - транспорт
Engine - двигатель
Drive - управлять (ехать)
Necessary - необходимый
ok - окей
Subway - метро
Whole - вся (площадь)
Sheet - лист, страница
Bus station - автовокзал
Foundation - фундамент
Any case - любой случай
Mortal - смертельный
Youth - молодежь
For example - например
Confuse - перепутать
Possible - возможно
Full of - полон чего
Control - контролирую
Border - граница
None of them - никто из них
Inform - информировать
Agreement - договоренность
Effect - последствия
Demand - требовать
Allow - разрешать (дозволяти)
Journey - поездка
Approach - подход
Charge - заведует (чем то)
Whose - чей, чья
Bowl - миска
Pure - чистый
Relationships - отношения (с родителями)
Neighborhood - район
Application - заявка
It's a matter of time - это дело времени
Introduction - вступление
Convenient - подходящий
Deny - отрицать
taxi - такси
Threat - угроза
admire - восхищаться
Impossible - невозможно
Loud - громко
Walk by - идти мимо
Certain - уверен
Higher - выше
be able - смогу (будущее)
Normal - обычный
Uncle - дядя
Put on - надевать (шапку)
In total - всего (нас всего)
Per - за (метр за секунду)
Majority - большинство
Count on - рассчитывать на
Gets - получает
communicate - общаться
Fits - подходит (одежда)
Serves - подавать (девушка подаёт воду)
he assumes - он предпологает
Achieve this aim - достигнуть этой цели
Lucky - везучий
Go away - уйди
Measure - меры
Notice - заметят
Department - отдел
Come back - вернуться (два слова)
Zoo - зоопарк
Criminal - преступник
The study - исследование
Announce - объявлять
Forgive - простить
Guess - отгадать
Brave - смелая
Share - разделять
Currency - валюта
Completely - полностью (согласен)
Watch your mouth - следи за словами
To be - быть
Include - включает (еда)
Easily - спокойно
A lot - много
any longer - не дольше
Rude - грубый
The Costs - издержки, расходы
There - там
Frequent - часто происходит
Correct - правильный
Choice - выбор
Responsible - ответственный
Razor - бритва
Evidence - доказательство
last for about - (это будет) длится около
Excellent - отлично E
Continue doing - продолжить делать
The only right - единственно верное
Yard - улица, двор
Interrupt - перебивать
Powder - порошок
Purpose - цель
Religious - верующая
Prefers - предпочитает
Attack - атаковать
Think it over - обдумать это
Despite - не смотря на (одно слово)
Whole night - всю ночь
Worker - рабочий
Authorities - власти
Exercise - заниматься спортом
Tower - башня
visa - виза
Anywhere - где угодно
The staff - сотрудники
Resolve the conflict - решить конфликт
Somehow - как то
Rest - отдыхать
Check - проверить
Available - доступен
Deep - глубоко
Square - площадь
Accident - происшествие
Accuse of - обвинять в
Attention - внимание
Beauty - красота
Cousin - двоюродный брат
Crime - преступление
Cross - пересекать (улицу)
Deliver - доставлять
Describe - описывать
Description - описание
Developed - развивать (past)
Died - умер (past)
Disappeared - исчезли (past)
Discover - открыть (Америку)
During - на протяжении (моего сна)
Effort - усилие
Enter - входить, вступать, поступать
Example - пример
Expected - ожидал (past)
Expectedly - ожидаемо
Following - следующие (ошибки)
Greatly - очень сильно
Calm - спокойный
Confirm - подтвердить
Face problem - столкнутся с проблемой
Guild - вина
Had a rest - отдыхал
I washed myself - я покупался
Introduce - представить
Invite to - приглашать на
Killed - убили (past)
Knock at - стучать в
Last for - длится _
Midnight - полночь
Negative - отрицательная
Opportunity - возможность
Pack - упаковать
Parcel - посылка
Park there - парковаться там
Partly - частично
Rarely - редко
Receive - получать, принимать
Required - требовало (past)
Returned - вернулся (past)
Saint - святой
She washed herself - она покупалась
Singer - певец
Skills - навыки
Strong - сильный
Task - задача
Tend - тенденция
The following - следующие (вопросы)
Thief - вор
Turn - поворачивать
Unique - уникальная
Wait for him - ждать его
I washed my face - я вымыл лицо
A couple of questions - пара вопросов
Abilities - способности
Appearance - внешность
Defend - защищать
Goods - товары
Moved - переехал (past)
Passed - сдал, прошел (past)
Perform - исполнять (выступать)
Prayed - молился
Provided - обеспечивали (предоставляли)
Reached - достиг
Require - требовать
Revised - повторённый, пересмотренный
Several - несколько
Sound - звучать
Stay - остаться
Stayed - оставался (past)
Suddenly - вдруг, внезапно
The day before yesterday - позавчера
Turn on - включить
Cheaper - дешевле
The same - то же самое (два слова)
Disappointed - расстроенный
Quite seldom - достаточно редко
Expect - ожидать
Happen to - произошло с
Happily - счастливо
Imagine - воображать
Punish - наказывать
Remained - оставался (past)
Seldom - редко
Suggested - предлагал (past)
Switch on - включить
Went to the park on foot - пошли в парк пешком (go)
Front - перед (домом)
Property - недвижимость
Report - отчёт
Vegetables - овощи
Late - опоздавший
Finish it - закончить это
Significantly - значительно (S)
owe them - Должен им
Anniversary - годовщина
Consider - учитывать
Innocent - невинный
Remain - остатся, продержатся
Revis - повторить, пересмотреть
Suggest - предлагать
Topic - тема
Fell - упал
Impress - впечатлять
Everywhere - везде
Amazing - восхитительно
Pair - пара
Sales - продажи
Double - удвоить
Afternoon - днем
Deserve - заслуживать
To get in touch with - связаться с
Adjective - прилагательное
Will Continue doing - будет продолжать делать
Certainly - конечно
Thin - тощий
Behave - ведёт себя
Special - особенный
West Coast - западный берег
Free - (быть) свободным
Bed Sheet - простынь
Wheel - колесо
Participate - принимать участие
Powerful - мощный
As always - как всегда, як завжди
How many - Сколько (друзей)
Siblings - братья и сёстры
Question mark - вопросительный знак
Invent - изобретать
Region - район R
Activity - деятельность
Explanation - объяснения
Slim - стройный
Valley - долина
Bilingual - двуязычный (знает два языка)
Suspicious - подозрительно
Suit - подходит
Walk into - зайти внутрь
manner - манера
Tall - высокий
Thoroughly - тщательно
Correctly - правильно
app - приложение
Absent - отсутствует
So what - ну и что?
Entry - вход
Prison - тюрьма
Go on - продолжать 2 слова
Aunt - тетка
Current - текущий (курс)
Polite - вежливый
Different - другой, разные
Might - возможно (modal)
Living - живой
By profession - по профессии
Clear - ясно понятно
Take place - проходит (иметь место)
I feel sorry for the boy - мне жаль этого парня
Repair - исправить
As - в то время когда (я ем _ я гуляю)
Surprising - удивительный
Assistant - ассистент
North - север
Nowhere - нигде
Shirt - рубашка
The end - конец
Meet - знакомиться, встречать
Twice - дважды
Roof - крыша
Build - строить
Apply - применить, подать заявку, занести
Beat - бить, победить
Reach - достиг, достигнуть, тянутся
Finish - закончить
Service - услуга
Construction - строительство
Act - поступок
Other countries - другие страны
Another country - другая страна
Another opportunity - еще одна возможность
It's very kind of you - это очень приятно с твоей стороны
Weak - слабый
Large - большой (L)
Able - способный, здібний
Older - старше (возраст)
Younger - младше (возраст)
Bigger - больше (размер)
More or less - более менее
Cleaner - чище (чистота)
Short - низкий, короткий
Bad - плохой
Take on - взять на
Absence - отсутствие, недостаток, неявка
response time - время отклика
Wake - будить, просыпаться, осознать, очнуться
Production - производство
View - вид, мнение, взгляд
Met - знаком
Living room - прихожая комната
Assume - допускать, Предполагать, присваивать себе
Transform - превратиться
Sharp - острый
Tremendous - огромный, потрясающий
Considerably - значительно (С)
Avenue - проспект
Opposite - противоположные
Bag - сумка
Manage - уметь (управлять)
Produce - производить
Performance - представление, исполнение, спектакль
Smaller - меньше (меньше меня)
Previously - ранее, предварительно, заранее
Especially - особенно, специально
Definitely - точно!, Определенно, разумеется!
Towards - к, в направлении, по отношению 
Carefully - осторожно, внимательно, бережно
Bring up - воспитывать
Take part - принимать участие
Age - возраст
Salary - зарплата
Go out - идти на выход, выходить
Come came come - вернуть (irregular verbs)
Send - отправить
had a good time together - провели хорошо время вместе
differently - по другому (иначе)
Prevent - Предотвращать, не допускать, предохранять
Exist - существовать
change of clothes - сменная одежда
Prettier - красивее
Since - поскольку, тому назад, (S)
Cheaply - дешево
using - испольЗУЯ
amount - количество (a)
favor - одолжение
bitterly - горько
quietly - тихо
upset - расстроенный (U)
Find out - узнали
Avoid - избегать
Protection - защита (P)
Content - состав, зміст, наполнение
Previous - предыдущий
Pretty - довольно, красиво
Though - хотя, однако, несмотря на, даже, всё таки
Efficient - эффективно
Bring in - приносить
Pronunciation - произношение
Mix up - перемешать
explain - объясни
Route - маршрут
Community - общество
Skirt - юбка
Start doing - начать делать
Impolite - невежливый
Borrow - брать в долг
By heart - наизусть
Immediately - сразу
Arm - рука
Promise - обещание
Throw at me - бросил в меня
Country house - загородный дом
Discount - скидка
Throw to me - бросил мне
Subject - предмет
Piece - кусок
At last - наконец
At least - принаймні, хотя бы
Take - брать
Later - позже
ago - назад (час назад)
hear it for the first time - слышу это первый раз
Sell for - продать за
School uniform - школьная форма
Part - часть
Give up - бросать (курить)
Courage - отвага
Complaint - жалоба
Throw away - выбросить
Stylish - стильная
Teach me a lesson - он преподал мне урок
I lay down - я лёг
Classmate - одноклассник
Catch - поймать
River - река
Increase - усилить, увеличить
space - космос, пространство
postpone - откладывать (на потом)
outstanding - выдающийся
Force - заставить
Accept - принять (A)
Affect - влиять, действовать (A)
Define - определять, давать характеристику
Pie - пирог
Masterpiece - шедевр
Courageously - отважно
Customer - покупатель
Currently - В настоящее время, теперь
Attractive - привлекательный
notify - уведомить, поставить в известность
Notification - уведомление
work properly - работать правильно
Spacious - просторная
Fashionable - модная
Half an hour - полчаса
Woke up - проснулся
Hole - яма, отверстие, дыра
It stopped working properly - Это перестало работать должным образом
Pond - пруд
Injury - рана, травма
constant - постоянный, постоянная величина
Continue - продолжать
Join - присоединится
with whom - с кем
i like better - мне нравится больше
belt - ремень
Jacket - куртка, пиджак
Sun - солнце
Leg - нога
He drowned - он утонул
Rose by - выросла на (цена)
Reduce - уменьшить
suffer - страдать
Hook - крюк
Employee - сотрудник
Tears - слёзы
Jewelry - украшения
finally - наконец
Drown - тонуть (человек)
Cycling - кататься на велосипеде
Recover - восстанавливать
Cover - открывать, освещать
Title - название
Damage - повреждение
Reality - реальность
Circle - круг
Exit - выход
Humor - юмор
Pleasure - удовольствие
Danger - опасность
Honor - честь
Efforts - усилия
Permission - разрешение
Load - груз
Interest - процент
Signature - подпись
Symbol - символ
Conversation - разговор
Murder - убийство
Shadow - тень
Entrance - вход
Establish the order - установить порядок
One chapter has turned into a book - один раздел превратился в книгу
Terrible - ужасно
Flutter - порхать
Benefit - выгода, польза
Religion - религия
Failure - провал
Origin - происхождение
Position - должность
Candle - свеча
Faith - вера
Total - полный, суммарный
Direction - инструкция, направление
Fear - страх
Strength - сильная сторона, сила
Relation - связь, отношения
Existence - существование
Desire - желание
Joy - радость
Attempt - спроба, попытка
Possibility - возможность
Birth - рождение
Marriage - свадьба
Miss - соскучиться (за кем
Birthday - день рождения
Expensive - дорогой
Flat - квартира
Divorced - разведен
Adult - взрослый
Grown Up - взрослый
Guest - гость
jug - кувшин
Chair - стул
Single - один
Funny - забавно
train - тренировка
toothbrush - зубная щётка
Poor - бедный
Clothes - одежда
Dry - сушить
I'll - болен
apartment - квартира (A)
Worry - беспокоить, волноваться
bruh - братан
Married - женат
Wonderful - Замечательный, чудесный
Eyes - глаза
Floor - пол
Lazy - ленивые
Feeling - чувство
Health - здоровье
Make a plan - составить план
Keep it simple - держать все простым
Take a break - сделать перерыв
Get some rest - отдохнуть
have a good time - хорошо проводить время
Get started - начать
Work hard - усердно работать
Stay focused - оставаться сосредоточенным
Give it a try - попробовать
Ask for help - попросить помощи
Be patient - быть терпеливым
Keep practicing - продолжать тренироваться
Take your time - не торопиться
Stay organized - оставаться организованным
Set a goal - поставить цель
Work towards your goal - работать на достижение цели
Believe in yourself - верить в себя
Never give up - никогда не сдаваться
Practice makes perfect - практика делает совершенным
Keep going - продолжать двигаться вперед
Stay positive - оставаться позитивным
Take a chance - рискнуть
Follow your dreams - следовать своим мечтам
Face your fears - преодолеть свои страхи
Trust your instincts - доверять своей интуиции
Speak up - говорить громче
Be yourself - быть самим собой
Stay true to yourself - оставаться верным себе
Live in the moment - жить в настоящем моменте
Take responsibility - нести ответственность
Admit your mistakes - признавать свои ошибки
Forgive and forget - прощать и забывать
Move on - идти дальше
Never lose hope - никогда не терять надежду
Keep an open mind - оставаться открытым к новому
Stay curious - быть любопытным
Explore the world - исследовать мир
Try new things - пробовать новые вещи
Embrace change - принимать перемену
Celebrate success - праздновать успехи
Accept failure - принимать неудачи
Learn from your mistakes - учиться на своих ошибках
Stay humble - оставаться скромным
Be grateful - быть благодарным
Help others - помогать другим
Give back - отдавать
Love unconditionally - любить безусловно
Cherish your loved ones - дорожить близкими
go to work - идти на работу
go home - идти домой
have fun - веселиться, развлекаться
take a shower - принимать душ
take a bath - принимать ванну
brush your teeth - чистить зубы
get dressed - одеваться
get undressed - раздеваться
put on clothes - надевать одежду
take off clothes - снимать одежду
do the laundry - стирать белье
do the dishes - мыть посуду
clean the house - убирать дом
cook dinner - готовить ужин
order food - заказывать еду
watch TV - смотреть телевизор
listen to music - слушать музыку
read a book - читать книгу
surf the internet - серфить в интернете
check email - проверять электронную почту
make a phone call - звонить по телефону
send a text message - отправлять текстовое сообщение
take a nap - вздремнуть
go for a walk - гулять
go for a run - бегать
do exercise - заниматься упражнениями
meditate - медитировать
meet friends - встречаться с друзьями
You don't say - не может быть
always the same - всегда одно и тоже
Zip it - закрой рот
Only once - только раз
Holy crap - чёрт возьми
Neither me nor yours - не моя и не твоя
Each other - друг друга
Go Shopping - ходить за покупками
Just in case - на всякий случай
The most interesting - самый интересный
No Biggie - не страшно
Just in time - как раз вовремя
catch up - догонять(два слова)
Perfectly realize - прекрасно осознавать
Another apple - еще одно яблоко
Is Anybody with you - с тобой кто то есть?
As far as i know - насколько я знаю
Non of us - никто из нас
Hurry up - торопиться
keep in touch - оставаться на связи
Sleep on it - обдумать еще раз
Every human - каждый человек
Only once in a year - только раз в год?
calm down - успокоиться
Point of view - точка зрения
He is away - он отсутствует (уехал далеко)
Not necessarily - не обязательно
nasty weather - неприятная погода
i mean - я имею в виду
flee - спасаться бегством
At once - сразу же (во первых)
Behave very badly - вести себя очень плохо
Have a rest - отдыхать
He washed himself - он покупался
To our surprise - к нашему удивлению
He is out - его нет дома (но он рядом)
Suggested going - предлагал пойти (past)
Wash up the dishes - мыть посуду
Piss me off - вывести из себя
What kind of - какого рода?
See you tomorrow - увидимся завтра
Pass by - проходят мимо
a Bit - немного B
Waste time - тратить время
Waste of time - потеря времени
Low blow - удар ниже пояса
Write it down - записывать что то
it seems to be - это кажется
Other side - другая сторона
Over time everything changes - со временем всё меняется
This problem has nothing to do with you - эта проблема не имеет к тебе отношения
On top - сверху
I have nothing to do with this matter - я не имею отношения к этому делу
In any case I like it here - во всяком случае мне нравится тут
How do i add images to my page - как мне добавить изображения на мою страницу
Have a good flight - желаю хорошего полёта
The side of the road - узбіччя дороги
One more time - еще раз
Do The Shopping - делать покупки
i heard it on tv - я услышал это по телевизору
stand up - встать
Much more - Гораздо более
Don't freak out - не паникуй
i leave for - я уехал в
i cut myself - я порезался
i mean to do it - я хочу сделать это
i heard it in the news - я услышал это в новостях
What made him change his mind - что заставило его изменить свое мнение
Sooner or later - рано или поздно
On time - вовремя
sit down - присесть
set up a company - основать компанию
Has turned into - превратился
For no reason - без какой либо причины
Break down - сломаться
Area - область, район
Island - остров
waterfall - водопад
Garden - сад
Corner - перекресток
Local - местный
Farm - ферма
Church - церковь
tent - палатка
puddle - лужа
Fair - ярмарок, справедливо, красавица, русый
queue - очередь
yield - возвращать последовательность
assignment - операция присваивания
pass by value - передача по значению
pass by reference - передача по ссылке
heap - куча
garbage collection - сборка мусора
algorithm - алгоритм
parameter - параметр
inheritance - наследование
polymorphism - полиморфизм
encapsulation - инкапсуляция
constructor - конструктор
static - статический
private - приватный
protected - защищенный
implementation - реализация
module - модуль
framework - фреймворк
platform - платформа
compiler - компилятор
interpreter - интерпретатор
debugger - отладчик
profiler - профилировщик
IDE - интегрированная среда разработки
version control - система контроля версий
Git - система контроля версий Git
merge - слияние
conflict - конфликт
commit - коммит
bug - ошибка
testing - тестирование
unit test - модульное тестирование
integration test - интеграционное тестирование
acceptance test - приемочное тестирование
regression test - регрессионное тестирование
code review - кодовый обзор
documentation - документация
comment - комментарий
code style - стиль кода
indentation - отступы
whitespace - пробельные символы
camelCase - стиль написания camelCase
snake_case - стиль написания snake_case
PascalCase - стиль написания PascalCase
request - запрос
response - ответ
session - сессия
cookie - куки
cache - кэш
routing - маршрутизация
middleware - промежуточное ПО
authentication - аутентификация
authorization - авторизация
encryption - шифрование
decryption - расшифровка
set - устанавливать
add - добавлять
create - создавать
delete - удалять
find - находить
sort - сортировать
update - обновлять
get - получать
compare - сравнивать
debug - отлаживать
error - ошибка
initialize - инициализировать
execute - выполнять
compile - компилировать
throw - выбрасывать исключение
function - функция
remove - удалять
prepend - добавлять в начало
decrement - уменьшать
exception - исключение
deallocate - освобождать память
class - класс
method - метод
array - массив
list - список
dictionary - словарь
pointer - указатель
case - случай
while - пока
do - делать
for - для
lambda - лямбда
reverse - обращать
increment - увеличивать
object - объект
iteration - итерация
loop - цикл
default - по умолчанию
return - возвращаемое значение
group - группировать
from - из
where - где
left - левый
right - правый
full - полный
key - ключ
value - значение
stack - стек
reference - ссылка
switch - переключатель
filter - фильтровать
allocate - выделять память
foreach - для каждого
select - выбирать
order - упорядочить
by - по
descending - убывающий
index - индекс
call by reference - вызов по ссылке
recursion - рекурсия
replace - заменять
variable - переменная
conditional - условный
map - отображать
inner - внутренний
outer - внешний
shift - сдвиг
capacity - емкость
logical - логические операции
argument - аргумент
pointer arithmetic - арифметика указателей
comparison - операции сравнения
call by value - вызов по значению
data structure - структура данных
interface - интерфейс
destructor - деструктор
virtual - виртуальный
abstract - абстрактный
aggregate - агрегировать
bitwise - побитовые операции
arithmetic - арифметические операции
stack overflow - переполнение стека
memory leak - утечка памяти
public - публичный
repository - репозиторий
branch - ветка
ascending - возрастаю
at the end of the meeting - в конце встречи
I busy next week - я занят на следующей неделе
Multiply - умножить
Early - рано
How often - как часто
Go to bed - ложиться спать
For years - годами
Nowadays - настоящее время (одно слово)
Get up - вставать
generation - поколение
at the beginning of the year - в начале этого года
Century - 100 летие
Division - деление
Usually - обычно
at first - сначала
Quickly - быстро Q
The day after tomorrow - послезавтра
In a year - (выучить) за год
As soon as possible - как можно быстрее
Slowly - медленно S
Fourth - четвёртое
Present day - сегодня
What time - в какое время
Decade - 10 летие
Earlier - ранее
Right now - прямо сейчас
ticket - билет
tsunami - цунами
abroad - за границей
gloomy - пасмурный
Rains - дощ
Get dark - темнеет
Windy - ветреный
Will Start doing - начнёт делать
Will finish doing - закончу делать (Будущее)
chief - начальник
Guard - охранник
An Important - не важный
Opinion - мнение
Trip - поездка
Clever - умный
Event - событие
Judge - судья
Busy - занят
Hard working - трудолюбивый
Stupid - глупый S
Commercial - коммерческий
Unknown - неизвестно
Equipment - оборудование
Legal - законный
Armchair - кресло
Useless - бесполезный
Dangerous - опасно
Angry - злой
Width - ширина
Memory - память
Useful - полезный
Complain - жалуется
Data - данные
Lend - давать в долг
police - полиция
Equal - одинаковые
Career - карьера
Advertising - реклама
Disagree - не согласен
On a business trip - в командировке
Trust - доверяю
Financial - финансовый
Desk - письменный стол
Decision - решение
Range - диапазон
Famous - известный
False - не правда
Get a job - получить работу
Important - важный
Ineffective - неэффективно
quantity - количество
On Holiday - На выходных
Lawyer - юрист
Sign - подписать
Success - успех
Rich - богатый
Article - статья
Earn - заработать
Append - добавить, присоединять
Potential - потенциальный
Length - длина
random - случайный
next - следующий
far - далёкий
most - наиболее
heavy - тяжёлый
own - собственный
dear - дорогой, уважаемый
better - лучший
clean - чистый
blue - синий
dark - тёмный
last - последний
green - зелёный
glad - радостный, рад (видеть)
orange - оранжевый
sweet - сладкий
close - близкий, закрыть
black - чёрный
nice - приятный
hot - горячий
crazy - безумный
cool - классный
beautiful - красивый
dirty - грязный
wild - дикий
ready - готовый
real - реальный
fresh - свежий
hard - тяжёлый, жёсткий
young - молодой
final - последний, решающий
true - истинный
mad - безумный
quick - быстрый
cheap - дешёвый
low - низкий
sad - грустный
yellow - жёлтый
high - высокий
small - маленький
same - тот же
cold - холодный
pink - розовый
white - белый
little - маленький
good - хороший
fast - быстрый
new - новый
usual - обычный
Inspire - вдохновлять
drunk - пьяный
long - длинный
kind - добрый
grey - серый
wrong - неправильный
warm - тёплый
more - более
light - более лёгкий, свет
red - красный
difficult - трудный
worse - хуже
easy - легко, лёгкий, спокойно 
soft - мягкий
less - менее, меньше
modern - современный
slow - медленный
social - общественный
dead - мёртвый
great - великий
happy - счастливый
big - большой
strange - странный
old - старый
main - главный
least - наименее, как минимум
fake - поддельный
again - снова
tomorrow - завтра
forward - вперёд
already - уже
back - назад
then - тогда
forever - навсегда
well - хорошо
even - даже
very - очень
down - вниз
yesterday - вчера
also - также
soon - скоро
never - никогда
enough - достаточно
always - всегда
today - сегодня
tonight - сегодня вечером
together - вместе
only - только
after - после
just - только, просто, только что
maybe - может быть
often - часто
now - сейчас
still - всё ещё, ещё, до сих пор
wing - крыло
voice - голос
heart - сердце
brain - мозг
eye - глаз
blood - кровь
mind - разум
face - лицо
mouth - рот
head - голова
soul - душа
nose - нос
ear - ухо
hair - волосы
body - тело
foot - нога
finger - палец
hand - рука
Take off - снять (одежду)
Pocket - карман
Trousers - брюки
Friendly - дружелюбный
cheese - сыр
bread - хлеб
dinner - ужин
fruit - фрукт
beer - пиво
pasta - макароны
tea - чай
apple - яблоко
supper - поздний ужин
cherry - вишня
lunch - обед
breakfast - завтрак
lemon - лимон
food - еда
juice - сок
sugar - сахар
soup - суп
meat - мясо
cake - пироженое
bottle - бутылка
milk - молоко
Unexpectedly - неожиданно
Should - следует
parent - родитель
egg - яйцо
girlfriend - девушка (его)
cat - кошка
flower - цветок
guy - парень, чувак
rat - крыса
water - вода
horse - лошадь
elephant - слон
bee - пчела
brother - брат
gold - золото
family - семья
bear - медведь
fire - огонь
wind - ветер
ground - земля
death - смерть
dad - папа
mom - мама
air - воздух
girl - девочка
enemy - враг
land - земля L
bull - бык
baby - крошка
forest - лес
dolphin - дельфин
pig - свинья
son - сын
mouse - мышь
lion - лев
dog - собака
sky - небо
moon - луна
chicken - курица, цыплёнок
engineer - инженер
smoke - дым, курить
husband - муж, супруг
man - человек, мужик
grass - трава
bird - птица
camel - верблюд
ice - лёд
people - люди
boy - мальчик
duck - утка
mother - мать
star - звезда
daughter - дочь
shit - дерьмо
policeman - полицейский
monkey - обезьяна
teacher - учитель
friend - друг
spider - паук
father - отец
color - цвет
tree - дерево
fox - лиса
person - человек
woman - женщина
weather - погода
sister - сестра
life - жизнь
nature - природа
sir - сэр
tiger - тигр
fish - рыба
silver - серебро
wolf - волк
wife - жена
beach - пляж
rain - дождь
stone - камень
lake - озеро
soldier - солдат
snow - снег
boyfriend - парень (её)
goose - гусь
eagle - орёл
child - ребёнок
animal - животное
cow - корова
sea - море
ocean - океан
button - кнопка
page - страница
bedroom - спальня
paradise - рай
home - дом
bus - автобус
price - цена
present - подарок
coin - монета
net - сеть
peace - мир
mirror - зеркало
language - язык
kitchen - кухня
bathroom - ванная
market - рынок
table - стол
half - половина
kingdom - королевство
war - война
lesson - урок
city - город
king - король
pencil - карандаш
picture - картинка
cup - чашка
ring - кольцо
fun - веселье
speech - речь
plate - тарелка
road - дорога
bike - мотоцикл
screen - экран
question - вопрос
room - комната
message - сообщение
knife - нож
wall - стена
top - верх
queen - королева
tale - сказка
luck - удача
spoon - ложка
book - книга
street - улица
clock - часы
word - слово
world - мир
victory - победа
mail - почта
power - сила
art - искусство
bed - кровать
place - место
devil - дьявол
game - игра
device - прибор
money - деньги
holiday - праздничный день
door - дверь
web - сеть, паутина
thing - вещь
song - песня
textbook - учебник
god - бог
way - путь
hospital - больница
window - окно
country - страна
shop - магазин
toilet - туалет
speed - скорость
party - вечеринка
car - автомобиль
joke - шутка
fork - вилка
box - коробка
capital - столица
name - имя, назвать
town - город (T)
letter - буква, письмо, символ
castle - замок
toy - игрушка
notebook - тетрадь
house - дом
pen - ручка
fortune - удача, случай
job - работа
school - школа
trouble - проблема
nickname - прозвище
news - новости
hell - ад
ball - мяч
ship - корабль
size - размер
truth - правда
Deserved - заслужила
put off - откладывать (на потом) два слова
give up smoking - бросить курить
Prepare for - подготовиться к
sorry - мне жаль
Lead to - приводит к
of - из
or - или
Smile at - улыбается над
Front of - перед ___
Depend on - зависит от
Solution to - решение __
Proud of - гордится за
and - и
than - чем, кроме, как
In general - в основном
against - против
In front - перед (собакой)
so - так
off - из, вне
Interested in - заинтересован в
over - над
Because of - из за (твоей собаки)
Ask for - просит _
yes/yeah - да
On Tuesday - во вторник
in - в
Grateful to for - благодарен __(кому за)
Reason for - причина __
Devote to - уделять (время) для
hello - привет
until - до тех пор (пока)
Fond of - обожаю
On a regular basis - на регулярной основе (регулярно)
but - но
because - потому что
In the beginning - в начале
Bad at - плохо от
Tired of - устал от
under - под
Marry - жениться на
Adapt to - адаптироваться к
Divide it into - делить это на
Happened to - произошло с
React to - реагировать на
Wait for - ждать _ (кого то)
Fell off into - упал с , на
In spite of - несмотря на (с предлогом)
Inform of - информировать о
Keen on - увлекатся
Will it last for - Сколько это продлится?
Pay for - платить за
Satisfied with - удовлетворён с
Laugh at - смеяться над
Refuse to - отказываться _
goodbye - до свидания
Look it up in a dictionary - найти это в словаре
please - пожалуйста
too - слишком
on - на
Insist on - настаивать на
However - Однако
Afraid of - испуган от
Influence - влиять на
On Wednesdays - по средам
Translate from into - переводить с на
bye - пока
Belong to - принадлежать
Attitude to - отношение к
hi - привет
with - с
without - без
not - не
Good at - хорошо от
Except for - кроме __(огурцов)
no - нет
near - около, рядом
Edge of - край _
Spend on - тратить на
Independent of - независимая от, самостоятельный _
Inside - изнутри, внутри
Point at - указать на
work for - Работать на
It's just a mouse - это просто мышь
Depends on - зависит от
In August - в августе
into - в
to - в, к
Instead of - вместо (него)
if - если
this - этот
about - о
such - такой
those - те
why - почему
someone - кто нибудь
at - в, на
nothing - ничто
who - кто
these - эти
any - любой
among - среди
somebody - кто нибудь
anything - что угодно
something - что нибудь
nobody - никто
we - мы
itself - сам
he - он
that - тот
upon - на
some - некоторое количество
everything - всё
every - каждый
away - прочь
many - много (идей)
another - другой (мир)
through - сквозь (через)
between - между
behind - за
when - когда
you - ты
each - каждый
much - много
everybody - каждый (человек)
around - вокруг
she - она
along - вдоль
other - другие
what - что
sometimes - иногда
anyone - любой
oneself - себя
few - мало
here - здесь
how - как
which - который
it - это
they - они
all - все
anybody - любой, никто, всякий (body)
before - до
above - выше, свыше, более
else - ещё, иначе, кроме
Library - библиотека
Fluently - свободно
Rightly - правильно (r)
pass - сдать (тест)
Sentence - речення
Simplicity - простота
Competition - соревнование
Elementary - элементарный
Obviously - очевидно
Intermediate - средний (уровень)
Advanced - продвинутый
Prepare - подготовится
Improve - улучшить
Brilliant - блестящий
Simple - простой
Expression - выражение
Wise - мудрый
In The end - в конце
Native speaker - носитель языка
Educated - образованный
Foreign - иностранный
multiplication - умножение
Beginner - новичок
Meaning - значение
Condition - условия
day - день
month - месяц
year - год
evening - вечер
Tuesday - вторник
hour - час
time - время
July - июль
September - сентябрь
April - апрель
Wednesday - среда
night - ночь
Friday - пятница
August - август
October - октябрь
summer - лето
November - ноябрь
spring - весна
winter - зима
week - неделя
Saturday - суббота
February - февраль
morning - утро
January - январь
autumn - осень
Thursday - четверг
June - июнь
March - март
Sunday - воскресенье
Monday - понедельник
December - декабрь
push - толкать
pull - тянуть
answer - отвечать
cook - готовить
win - побеждать
play - играть
walk - идти пешком
kiss - целовать
wash - мыть
teach - учат, обучать
end - заканчивать
could - мог
smile - улыбаться
know - знать
live - жить
sleep - спать
must - должен
think - думать
give - давать
die - умирать
lose - проигрывать
believe - верить
jump - прыгать
fight - драться
hunt - охотиться
come - приходить
start - начинать
show - показывать
help - помогать
dream - мечтать
change - изменять
mix - смешивать
have - иметь
paint - рисовать
read - читать
eat - кушать
buy - покупать
stop - останавливать
cry - плакать
swim - плавать
tell - говорить (кому то)
keep - держать (хранить)
look at - смотреть на
watch - смотреть (телевизор)
study - учиться
feel - чувствовать
work - работать
choose - выбирать
can - может
wish - желать
dance - танцевать
fill - наполнять
repeat - повторять
respect - уважать
sing - петь
may - мочь
hate - ненавидеть
sell - продавать
want - хотеть
hold - держать
make - делать (что то новое)
relax - расслабляться
sit - сидеть
like - любить
listen - слушать
need - нуждаться
write - писать
see - видеть
stand - стоять
mean - означать, иметь в виду
go - идти
travel - путешествовать
print - печатать
wait - ждать
learn - учиться
forget - забывать
fall - падать
cut - резать
open - открывать
fly - летать
become - стать
ask - спрашивать
hope - надеяться
Frighten - пугает
kill - убийство
love - любить
use - использовать
understand - понимать
call - вызов, призыв, зов
enjoy - наслаждаться
save - спасать
fuck - трахать
put - класть
move - двигаться
let - позволять
speak - говорить
talk - разговаривать
remember - помнить
pay - платить
drink - пить
hear - слышать
translate - переводить
run - бежать
excuse - извинять
begin - начинать
break - ломать, перерыв
try - пробовать
Cost - стоить (глагол)
Separately - раздельно
Furniture - мебель
Delicious - очень вкусно
Elder - старше
Behaviour - поведение
Inconvenient - неудобно (время)
Advertisement - рекламное объявление
Fat - толстый
Disease - болезнь (тяжелая)
Alone - (живёт) сама
Reply - ответ (редко)
Experience - опыт
Phrase - фраза
Celebrate - праздновать
Comfortable - удобное
Criticize - критиковать
Illness - болезнь (простуда)
Compete - соревноваться
Tasty - вкусно
Listen to - слышать кого
third - третий
twenty - 20
first - первый
ten - 10
two - 2
five - 5
sixteen - 16
number - число
three - 3
hundred - 100 (сто)
four - 4
eighteen - 18
eleven - 11
zero - 0
nineteen - 19
thirteen - 13
second - второй
eight - 8
six - 6
seventeen - 17
fifteen - 15
thousand - 1000
seven - 7
one - 1
fourteen - 14
twelve - 12
have had had - иметь
Do did done - делать
Make made made - делать
know knew known - знать
Tell told told - говорить кому то
Become became become - стал
put put put - положить
Find found found - найти
Give gave given - дать
begin began begun - начинать
let let let - позволить
Write wrote written - писать
Go went gone - идти
Say said said - сказал
Speak spoke spoken - разговаривать (говорить)
cost cost cost - стоить
See saw seen - видеть
Leave Left Left - оставил, покинул
Choose chose chosen - выбирать
read read read - читать
Lose lost lost - терять
Pay paid paid - платить
set set set - установить
Understand understood understood - понимать
Cut cut cut - резать
Win won won - выигрывать
Send sent sent - отправлять
Keep kept kept - хранить
meet met met - встречать
Spend spent spent - тратить
Sell sold sold - продать
Break broke broken - ломать
Fight fought fought - сражаться
Sleep slept slept - спать
Fit fit fit - подходит (идёт)
Overcome overcame overcome - преодолеть
Hit hit hit - ударить
Lend lent lent - одолжить (кому то)
Forgive forgave forgiven - прощать
Hurt hurt hurt - обижать, задеть, слегка повредить
Deal dealt dealt - иметь дело
Dig dug dug - рыть
Hold held held - держать в руках
Overpay overpaid overpaid - переплатить
Wear wore worn - носить (одежду)
Shoot shot shot - стрелять
Redo redid redone - переделать
Oversleep overslept overslept - проспать
Overeat overate overeaten - переедать
Drive drove driven - ехать
Burn burnt burnt - гореть
Underpay underpaid underpaid - недоплачивать
Foresee foresaw foreseen - предвидеть
Spoil spoilt spoilt - портить
Ring rang rung - звонить
Feel felt felt - чувствовать
Hear heard heard - слышать
Can could - могу, умею
be was were been - быть
mean meant meant - иметь в виду (означать)
run ran run - бежать
Fall fell fallen - упал
stand stood stood - встать (он встал)
Eat ate eaten - есть, кушать
Drink drank drunk - пить
Think thought thought - думать
get got got - получать
learn learnt learnt - учить (учится)
Grow grew grown - расти, выращивать
show showed shown - показывать
Sing sang sung - петь
Draw drew drawn - рисовать
Lie lied lied - Врать (не путать с лежать)
Withdraw withdrew withdrawn - снять деньги
nine - 9
Issue - проблема
Death died die - умер
Dream dreamt dreamt - мечтать
Teach taught taught - преподавать
Wake woke waken - просыпаться
Blow blew blown - дуть
Throw threw thrown - бросать
Misunderstand misunderstood misunderstood - неправильно понять
Rise rose risen - вставать, подъем (сонце)
Smell smelt smelt - пахнуть
Tear tore torn - рвать
Take took taken - брать
Instance - случай, пример
Establish - основывать, установить
ridge - хребет
Recent - свежая
Leave - покидать
sit sat sat - сидеть
Ride rode ridden - водить, ехать
Feed fed fed - кормить
Forget forgot forgotten - забывать
Fly flew flown - летать
Sink sank sunk - тонуть
Permit - разрешение, пропуск
